Access|Acc
Access Road
Alley|Allee|Ally|Aly
Arcade|Arc
Avenue|Ave|Av|Aven|Avenu|Avn|Avnue
Bay
Belt|Blt
Bend|Bnd
Boulevard|Bvd
Brae
Bypass|Bypa|Bypas|Byps|Byp
Circle|Circ|Circl|Crcl|Crcle|Cir
Close|Cl|Cls
Common|Cmn
Court|Ct
Courts|Cts
Cove|Cve|Cv
Crescent|Cr|Cres|Crsnt|Crsent
Crest|Crst
Dell
Downs
Drive|Dr|Driv|Drv
End
Esplanade|Esp
Gardens|Gdns
Gate|Gte
Glade|Glde
Glen
Green|Grn
Greens
Grove|Grve|Gr
Heights|Hts
Highway|Highwy|Hiway|Hiwy|Hway|Hwy
Hill|Hl
Key|Ky
Landing|Lndng|Lndg
Lane|Ln
Line
Link|Lnk
Loop|Lp
Loop Road|Lp Rd
Mall
Mews
Mile
Motorway|Mtwy
Oaks
Paddock|Pdk
Parade|Pde
Park|Prk
Parkway|Parkwy|Pkway|Pky|Pkwy
Pass|Pss
Place|Pl|Plce
Point|Pnt
Promenade|Prom
Quay|Qy
Ridge|Rdge|Rdg
Rise
Road|Rd
Roadway|Rdway|Rdwy
Row|Rw
Side Road|Side Rd
Spur|Spr
Square|Sq|Sqr|Squ|Sqre
Steps|Stps
Strand|Strnd
Street|Strt|St
Terrace|Tce|Terr|Ter
Track|Trck|Trk
Vale|Vl|Vle
Valley|Vally|Vlly|Vly
View|Vw
Views|Vws
Vista|Vist|Vst|Vsta|Vis
Walk|Wlk|Wk
Way|Wy
Wharf|Whrf